// Use http://centricle.com/tools/ascii-hex/ for hex codes
dashedCell=虚线
edit=编辑
editFlowForm=配置流程表单
editActivityForm=配置环节表单
checkin=发布
tasks=任务栏
orientation=旋转
rounded=圆角
format=格式
layout=布局
urlHelp=help/index.html
lastSaved=最后更新
currentFile=当前文件
toolbar=工具栏
save=保存
print=打印
Format=格式
Rounded=圆角
cut=剪切
copy=复制
paste=粘贴
delete=删除
undo=撤消
redo=重做
select=选择
connect=连接
pan=抓取
zoomIn=放大
zoomOut=缩小
zoom=大小
fit=适合大小
actualSize=实际大小
selectAll=全部选择
clearSelection=清除选择
shape=形状
format=格式
font=字体
group=分组
ungroup=取消分组
removeFromParent=Orphan
align=对齐
left=左对齐
right=右对齐
center=水平居中
top=上对齐
middle=垂直居中
bottom=下对齐
collapse=折叠
expand=展开
toBack=置后
toFront=置前
enterGroup=进入组
exitGroup=退出组
layout=布局
horizontalTree=水平树
verticalTree=垂直树
fillColor=填充颜色
strokeColor=线颜色
gradientColor=渐变
bold=粗体
italic=斜体
fontColor=字体颜色
fontSize=字体大小
fontFamily=字体
examples=示例
newDiagram=新建
image=图片
opacity=透明度
selection=选择
editStyle=样式
enterStyle=输入样式
enterColorname=输入色值
enterImageUrl=输入图片URL
enterOpacity=输入透明度 (\)
enterFontsize=输入字体大小 (pt)
enterFontfamily=输入字体
toggleRounded=圆角
toggleShadow=投影
openHref=打开URL
show=预览
ci=提交
exportImage=输出图片
changesLost=放弃所有修改!
swimlanes=泳道
travelBooking=旅行预订
notAvailable=无法使用
task=任务
Task=任务
Rhombus=任务
Ellipse=任务
RoundTask=任务
loadsample=从模板创建
template1=通用模板
copyFlow=流程复制